.......................................﻿
.......................................
.......................................
.......................................
.......................................
....###############################....
.......................................
.......................................
.......................................
.......................................
.......................................
.......................................
.......................................
.......................................
.....##############################....
.......................................
.......................................
.......................................
.......................................
.......................................
.......................................
.......................................
.......................................
.......................................
.......................................
.......................................
.......................................
.......................................
.......................................
.......................................
.....##############################....
.......................................
.......................................
.......................................
.......................................
.......................................
.......................................
.......................................
.......................................
.......................................