.......................................
.......................................
.......................................
..........#...............#............
..........#...............#............
..........#...............#............
..........#...............#............
..........#...............#............
..........#...............#............
..........#################............
.....##############################....
.......................................
.......................................
.......................................
.......................................
.......................................
.......................................
.......................................
﻿....###############################....
.......................................
.......................................
.......................................
.......................................
.......................................
.......................................
.......................................
.....##############################....
............################...........
............#..............#...........
............#..............#...........
............#..............#...........
............#..............#...........
............#..............#...........
.......................................
.......................................
.......................................
.......................................
.......................................
.......................................
.......................................